NO ./textures/bluestone.xpm
SO ./textures/eagle.xpm
WE ./textures/eagle.xpm
EA ./textures/bluestone.xpm
C 10, 10, 10
F 10, 10, 10

111111111111111
100000000000001
100000000000001
100000000000001        111111111111
1000000N0000001        100000000001
100000000000001        100000000001
100000000000001        100000000001
100000000000001        111110111111 
111111111111111