NO ./textures/bluestone.xpm
SO ./textures/eagle.xpm
WE ./textures/eagle.xpm
EA ./textures/bluestone.xpm

F 101,   67,    33

C 135,   0,    235

111111111111111111111111111111
100000000000000000000000000001
100000000000000000000000000001
100000000000000110000000000001
100000000000000110000000000001
1000000N0000000000000000000001111111111111111
100000000000000000000000000000000000000000001
100000000000000000000000000000000000000000001
111111111111111111111111111111111111111100001
                                       100001
                                       100001
                                       100001
                                       100001
                                       1000011111111111111111111
                                       1000000000000000000000001
                                       1111111111111111111111111
